T,T,F,T,T,T,T
T,T,T,T,T,T,T
T,T,T,T,T,F,T
T,T,T,T,T,T,T
T,T,F,T,T,T,T
T,T,T,T,T,T,T
T,T,T,T,T,T,T